{
  "1": {
    "1": 75,
    "2": 63,
    "3": 58,
    "4": 56,
    "5": 55,
    "6": 54,
    "7": 54,
    "8": 53,
    "9": 53,
    "10": 53,
    "11": 52
  },
  "5": {
    "5": 130,
    "6": 125,
    "7": 121,
    "8": 119,
    "9": 117,
    "10": 115,
    "11": 114,
    "12": 113,
    "13": 112,
    "14": 111,
    "15": 110
  },
  "10": {
    "10": 235,
    "11": 232,
    "12": 229,
    "13": 227,
    "14": 225,
    "15": 223,
    "16": 222,
    "17": 221,
    "18": 219,
    "19": 218,
    "20": 218
  },
  "15": {
    "15": 365,
    "16": 363,
    "17": 360,
    "18": 358,
    "19": 357,
    "20": 355,
    "21": 354,
    "22": 352,
    "23": 351,
    "24": 350,
    "25": 349
  },
  "20": {
    "20": 495,
    "21": 493,
    "22": 491,
    "23": 489,
    "24": 488,
    "25": 486,
    "26": 485,
    "27": 483,
    "28": 482,
    "29": 481,
    "30": 480
  },
  "25": {
    "25": 600,
    "26": 598,
    "27": 596,
    "28": 595,
    "29": 593,
    "30": 592,
    "31": 590,
    "32": 589,
    "33": 588,
    "34": 587,
    "35": 586
  },
  "30": {
    "30": 705,
    "31": 703,
    "32": 702,
    "33": 700,
    "34": 699,
    "35": 697,
    "36": 696,
    "37": 695,
    "38": 693,
    "39": 692,
    "40": 691
  },
  "35": {
    "35": 810,
    "36": 808,
    "37": 807,
    "38": 805,
    "39": 804,
    "40": 803,
    "41": 801,
    "42": 800,
    "43": 799,
    "44": 798,
    "45": 797
  },
  "40": {
    "40": 915,
    "41": 913,
    "42": 912,
    "43": 910,
    "44": 909,
    "45": 908,
    "46": 907,
    "47": 905,
    "48": 904,
    "49": 903,
    "50": 902
  },
  "45": {
    "45": 1070,
    "46": 1068,
    "47": 1067,
    "48": 1066,
    "49": 1064,
    "50": 1063
  },
  "50": {
    "50": 1070
  }
}
