{
  "1": {
    "1": 8,
    "2": 6,
    "3": 6,
    "4": 6,
    "5": 6,
    "6": 5,
    "7": 5,
    "8": 5,
    "9": 5,
    "10": 5,
    "11": 5
  },
  "10": {
    "10": 24,
    "11": 23,
    "12": 23,
    "13": 23,
    "14": 23,
    "15": 22,
    "16": 22,
    "17": 22,
    "18": 22,
    "19": 22,
    "20": 22
  },
  "20": {
    "20": 50,
    "21": 49,
    "22": 49,
    "23": 49,
    "24": 49,
    "25": 49,
    "26": 48,
    "27": 48,
    "28": 48,
    "29": 48,
    "30": 48
  },
  "30": {
    "30": 71,
    "31": 70,
    "32": 70,
    "33": 70,
    "34": 70,
    "35": 70,
    "36": 70,
    "37": 69,
    "38": 69,
    "39": 69,
    "40": 69
  },
  "35": {
    "35": 81,
    "36": 81,
    "37": 81,
    "38": 81,
    "39": 80,
    "40": 80,
    "41": 80,
    "42": 80,
    "43": 80,
    "44": 80,
    "45": 80
  },
  "40": {
    "40": 92,
    "41": 91,
    "42": 91,
    "43": 91,
    "44": 91,
    "45": 91,
    "46": 91,
    "47": 91,
    "48": 90,
    "49": 90,
    "50": 90
  },
  "50": {
    "50": 107
  }
}
